Annex	Library Annex	annex
Bailey	Bailey Hortorium	mann
Kheel	Kheel Center	ilr
Manuscripts	Rare and Manuscript Collections	rare
Adelson	Adelson Library	ornithology
Africana	Africana Library	africana
Biochem	Biochem Reading Room (Biotech)
CISER	CISER Data Archive	ciser
Fine	Fine Arts Library	finearts
Food	Food Science Library
ILR	ILR Library	ilr
Catherwood	Catherwood Library	ilr
Kroch	Kroch Library Asia	asia
Law	Law Library	law
Legal	Law Library	law
Management	Management Library	johnson
Mann	Mann Library	mann
Mathematics	Mathematics Library	mathematics
Mountain	Iron Mountain
Music	Music Library	music
Nestle	Nestl√© Library	hotel
Olin	Olin Library	olinuris
Space	Spacecraft Planetary Imaging Facility	spif
Uris	Uris Library	olinuris
Veterinary	Veterinary Library	vet
